ronddwalen	wonderland
tarwe	water
bloedgevers	voedselberg
bloedvlek	bedelvolk
boekdelen	onbekleed
brein	berin
broeder	beroerd
bruut	buurt
charmeren	marcheren
citroen	contrei
zondig	donzig
muildier	delirium
dierenasiel	idealiseren
dieselmotor	mosterdolie
darmgas	smaragd
waterval	welvaart
wachtpost	stopwatch
wilde	dweil
geldwezen	gezwendel
geest	steeg
waard	award
